"seurat_clusters","mutant","wildtype","total_cells","pct_wildtype","pct_mutant"
"0",4823,866,5689,15.2,84.8
"1",919,2332,3251,71.7,28.3
"2",1554,749,2303,32.5,67.5
"3",1241,667,1908,35,65
"4",902,560,1462,38.3,61.7
"5",964,464,1428,32.5,67.5
"6",937,480,1417,33.9,66.1
"7",705,654,1359,48.1,51.9
"8",1118,21,1139,1.8,98.2
"9",752,201,953,21.1,78.9
"10",909,1,910,0.1,99.9
"11",125,547,672,81.4,18.6
"12",1,569,570,99.8,0.2
"13",552,0,552,0,100
"14",318,175,493,35.5,64.5
"15",233,151,384,39.3,60.7
"16",169,96,265,36.2,63.8
"17",125,58,183,31.7,68.3
"18",21,55,76,72.4,27.6
